0000000000
010000a440
0400000040
0400000040
0404c40040
0a03040040
0402040040
0404044440
044b000000
0000000000
