0000000000
010000a440
0400000040
0400000040
0404a40040
0404040040
0404040040
040404a440
044a000000
0000000000
