000
0
0
0
0
0
00000000000000000000000000000000000000000000000000000
0444444444444444444444444444444444444444444444444440
0444444444444444444444444444444444444444444444444440
0444c1b444444444444444444444444444444444444444444440
04444a4444444444444444444444444444444444444444444440
0444442444444444444444444444444444444444444444444440
0444443444444444444444444444444444444444444444444440
0444444444444444444444444444444444444444444444444440
0444444444444444a44444444444444444444444444444444440
0444444444444444444444444444444444444444444a44444440
0444444444444444444444444444444444444444444444444440
0444444444444444444444444444444444444444444444444440
0444444444444444444444444444444444444444444444444440
0444444444444444444444444444444444444444444444444440
0444444444444444444444444444444444444444444444444440
0444444444a44444444444444444444444444444444444444440
0444444444444444444444444444444444444444444444444440
0444444444444444444444444444444444444444444444444440
0444444444444444444444444444444444444444444444444440
0444444444444444444444444444444444444444444444444440
0444444444444444444444444444444444444444444444444440
0444444444444444444444444444444444444444444444444440
0444444444444444444444444444444444444444444444444440
0444444444444444444444444444444444444444444444444440
0444444444444444444444444444444444444444444444444440
0444444444444444444444444444444444444444444444444440
0444444444444444444444444444444444444444444444444440
04444444444444444a4444444444444444444444444444444440
0444444444444444444444444444444444444444444444444440
0444444444444444444444444444444444444444444444444440
0444444444444444444444444444444444444444444444444440
0444444444444444444444444444444444444444444444444440
0444444444444444444444444444444444444444444444444440
0444444444444444444444444444444444444444444444444440
0444444444444444444444444444444444444444444444444440
0444444444444444444444444444444444444444444444444440
0444444444444444444444444444444444444444444444444440
0444444444444444444444444444444444444444444444444440
0444444444444444444444444444444444444444444444444440
0444444444444444444444444444444444444444444444444440
044444444444444444444444444444444444a444444444444440
04444444444a4444444444444444444444444444444444444440
0444444444444444444444444444444444444444444444444440
0444444444444444444444444444444444444444444444444440
0444444444444444444444444444444444444444444444444440
0444444444444444444444444444444444444444444444444440
0444444444444444444444444444444444444444444444444440
0444444444444444444444444444444444444444444444444440
0444444444444444444444444444444444444444444444444440
0444444444444444444444444444444444444444444444444440
0444444444444444444444444444444444444444444444444440
0000000000000000000000000000000000000000000000000000
