0000000000
010000c440
0400000040
0400000040
0404a40040
0404040040
0404040040
040404d440
044b000000
0000000000
